speed:0.95
---
..........
..........
..........
..........
..........
..........
..........
..........
..........
..........
..........
..........
..........
..........
..........
..........
..........
.F.22.F...
.3332211..
.333.211..
