speed:0.9
---
..........
..........
..........
..........
..........
..........
..........
..........
..........
..........
..........
..........
..........
..........
..........
..........
...F......
.4455F6...
.445566...
1144.566..
