speed:0.9
---
..........
..........
..........
..........
..........
..........
..........
..........
..........
..........
..........
..........
..........
..........
..........
..........
.F..F..F..
.223.5577.
.2233557..
1122335577
