speed:0.85
---
..........
..........
..........
..........
..........
..........
..........
..........
..........
..........
..........
..........
..........
..........
..........
.F........
.66.F.44..
.6633.44..
.6633F.11.
1166334411
