speed:0.8
---
..........
..........
..........
..........
..........
..........
..........
..........
..........
..........
..........
..........
..........
..........
.F...F....
.44..33...
.44..33F..
.44..33...
11445533..
1144553377
