speed:0.8
---
..........
..........
..........
..........
..........
..........
..........
..........
..........
..........
..........
..........
..........
.F..F..F..
.22.55.77.
.22.55.77.
F22.55.77F
.22.55.77.
1122555771
1122555771
