speed:0.75
---
..........
..........
..........
..........
..........
..........
..........
..........
..........
..........
..........
..........
..........
..........
.F........
.33...F...
.33.6644..
F33.66.4F.
.33.6644..
1133664411
