speed:0.75
---
..........
..........
..........
..........
..........
..........
..........
..........
..........
..........
..........
..........
..F....F..
..22..55..
..22..55..
F.22..55.F
..22..55..
..22..55..
1122..5511
1122665511
