speed:0.7
---
..........
..........
..........
..........
..........
..........
..........
..........
..........
..........
..........
..........
..........
.F.F.F.F..
.11.33.55.
.11.33.55.
.11.33.55.
F11.33.55F
.11.33.55.
1111335577
