speed:0.7
---
..........
..........
..........
..........
..........
..........
..........
..........
..........
..........
..........
.F..F..F..
.44.22.66.
.44.22.66.
F44.22.66F
.44.22.66.
.44.22.66.
.44.22.66.
1144225661
1144225661
