speed:0.65
---
..........
..........
..........
..........
..........
..........
..........
..........
..........
..........
..........
..........
F.F.F.F.F.
.77.33.11.
.77.33.11.
.77F33F11.
.77.33.11.
.77.33.11.
5577331155
5577331155
