speed:0.65
---
..........
..........
..........
..........
..........
..........
..........
..........
..........
..........
..........
F....F....
44..22..66
44..22..66
44F.22F.66
44..22..66
44..22..66
44..22..66
4411221166
4411221166
