speed:0.4
---
..........
..........
..........
..........
..........
..........
..........
FFFFFFFFFF
.11.33.55.
.11.33.55.
F11F33F55F
.11.33.55.
.11.33.55.
F11F33F55F
.11.33.55.
.11.33.55.
.11.33.55.
711733755.
711733755.
711733755.
